+---+---+---+---+---+---+---+---+---+---+---+---+---+---+---+---+---+---+---+---+---+---+---+---+---+---+---+---+---+---+---+---+---+---+---+---+---+---+---+---+---+---+---+---+---+---+---+---+---+---+---+---+---+
| S |           |           |                                   |           |                   |               |                   |   |                       |           |           |           |               |
+   +   +---+   +   +---+   +   +---+---+---+   +   +---+---+   +---+   +   +   +---+---+   +---+   +---+   +---+   +   +---+---+   +   +   +---+---+---+   +   +   +---+   +   +---+---+   +---+   +   +---+   +---+
|   |   |   |   |   |   |           |       |   |           |       |   |   |   |           |       |   |       |   |   |               |   |   |       |   |       |   |   |       |       |   |   |       |       |
+   +   +   +   +   +   +---+---+---+   +   +---+---+---+   +---+   +   +   +   +   +---+---+   +---+   +---+   +   +   +---+---+---+---+   +   +   +   +   +---+---+   +   +---+   +---+---+   +   +---+---+---+   +
|           |   |               |       |                   |   |   |   |   |   |   |       |   |           |   |   |   |       |           |   |   |       |           |               |           |       |       |
+   +---+---+   +---+---+---+   +   +---+---+---+---+---+---+   +   +   +   +   +   +   +   +   +   +---+---+   +   +   +   +   +   +---+---+   +   +---+---+   +   +---+---+---+---+   +   +---+---+   +   +   +---+
|   |       |   |           |   |   |       |           |       |   |   |   |   |       |       |           |       |       |                   |   |       |   |               |       |   |           |   |       |
+---+   +   +   +   +   +---+   +   +   +   +   +   +---+   +   +   +   +---+   +---+---+---+---+   +---+   +---+---+---+---+---+---+---+---+---+   +   +   +   +---+---+---+   +   +---+   +   +---+---+   +---+   +
|       |       |   |           |   |   |       |   |       |       |       |   |       |       |   |   |           |       |               |       |   |   |               |       |   |       |   |       |       |
+   +---+---+   +   +---+---+---+   +   +---+---+---+   +---+---+---+---+   +   +   +   +   +   +   +   +---+   +   +---+   +   +---+---+   +   +---+   +---+---+---+---+   +---+---+   +---+---+   +   +---+   +   +
|   |       |   |   |       |       |   |           |       |               |       |   |   |               |   |           |       |   |   |       |   |       |       |   |                   |   |           |   |
+   +   +   +---+   +---+   +   +---+   +   +---+   +---+   +   +---+   +---+---+---+   +---+---+---+---+   +   +---+---+---+---+   +   +   +---+   +   +   +   +   +   +   +   +---+   +---+   +   +---+---+---+   +
|       |       |           |   |       |       |       |       |       |               |           |       |                   |   |   |   |       |       |       |       |       |       |               |       |
+   +---+---+   +---+---+   +   +   +---+---+   +---+   +---+---+   +---+   +---+---+---+   +---+   +   +---+---+---+---+   +---+   +   +   +   +---+---+   +---+---+---+   +---+   +---+   +   +---+---+---+   +---+
|           |           |   |   |           |       |   |               |               |   |       |   |           |       |       |   |       |       |   |           |       |   |       |   |               |   |
+   +---+---+   +---+---+   +   +   +---+   +---+   +   +   +---+---+---+---+---+---+   +   +---+   +   +---+---+   +   +   +   +---+   +---+   +   +   +---+   +---+   +---+   +---+   +---+   +   +---+---+---+   +
|   |           |           |   |       |       |   |               |               |   |       |   |               |   |   |   |               |   |   |       |   |       |       |   |       |   |               |
+   +   +---+---+   +---+---+   +---+   +---+   +   +---+---+---+---+   +---+---+   +   +---+   +   +---+---+---+   +   +   +   +   +---+---+---+   +   +   +---+   +---+   +---+   +   +   +---+   +---+   +---+---+
|   |               |           |   |   |   |   |       |               |           |       |   |   |       |   |   |   |   |   |   |       |       |       |           |   |           |       |       |           |
+---+---+---+---+---+   +---+---+   +   +   +   +---+   +   +---+---+---+   +---+   +---+   +   +   +   +   +   +   +   +   +   +---+   +   +   +---+---+---+   +---+   +   +---+---+---+---+---+---+   +   +---+   +
|                       |           |   |   |   |       |       |       |   |           |   |   |       |   |       |   |   |   |       |   |   |               |       |           |                   |   |       |
+   +---+   +---+---+---+---+---+   +   +   +   +   +---+---+   +---+   +   +---+---+---+   +   +---+---+   +   +---+   +   +   +   +---+   +   +   +---+---+---+   +---+---+---+   +   +---+---+---+---+   +   +---+
|   |       |       |           |           |       |       |       |   |                   |   |       |   |       |   |   |           |   |       |       |           |           |   |       |           |       |
+   +---+---+   +   +   +---+   +---+---+---+   +---+   +---+---+   +   +---+---+---+---+---+   +   +   +   +---+   +   +   +---+---+---+   +---+---+   +---+   +---+---+   +   +---+   +   +---+   +---+---+   +   +
|           |   |       |       |           |   |               |   |                   |       |   |   |   |   |   |   |       |                   |           |           |   |       |           |       |   |   |
+   +---+   +   +---+---+   +---+   +---+   +   +---+---+   +---+   +---+   +---+---+   +   +   +---+   +   +   +   +   +---+   +   +---+---+   +---+   +---+---+   +---+---+   +   +---+---+---+---+   +   +---+   +
|   |   |       |           |       |   |   |           |       |           |       |   |   |       |       |       |   |   |   |           |   |       |       |       |       |                   |   |       |   |
+   +   +---+---+   +---+   +   +---+   +   +---+---+   +---+   +---+---+---+   +   +   +---+---+   +   +---+   +---+   +   +   +---+---+   +   +   +---+   +   +---+   +---+---+---+---+---+---+   +   +---+   +   +
|           |       |       |   |       |       |   |                       |   |   |               |   |   |   |       |   |   |       |   |   |   |       |       |                   |           |   |           |
+   +---+---+   +---+   +---+   +   +---+---+   +   +   +---+---+---+---+---+   +   +---+---+---+---+   +   +   +   +---+   +   +---+   +   +---+   +---+   +---+---+---+---+---+   +   +   +---+---+   +---+---+---+
|   |           |           |       |           |       |               |       |       |       |       |       |       |   |       |   |       |           |               |       |   |   |       |               |
+---+   +---+---+   +---+---+---+   +   +---+---+   +---+   +---+---+   +   +---+---+   +   +   +   +---+---+---+---+   +   +---+   +   +---+   +---+---+   +   +---+---+   +   +---+---+   +   +   +   +---+---+   +
|       |       |   |               |   |       |   |   |   |       |       |       |   |   |   |   |           |       |       |   |       |               |   |   |       |   |           |   |           |       |
+   +---+   +   +---+   +---+---+---+   +   +---+   +   +   +   +   +---+---+---+   +   +   +   +   +   +---+   +   +---+   +---+   +   +   +---+---+---+---+   +   +   +---+   +   +---+---+---+---+   +---+   +   +
|           |           |           |   |               |       |   |           |   |       |       |   |   |       |       |       |   |   |       |           |   |   |       |   |               |   |       |   |
+   +---+---+---+---+---+---+---+   +   +   +---+---+---+---+---+   +---+   +   +   +---+---+---+---+   +   +---+---+   +   +   +---+   +   +   +---+   +---+---+   +   +---+   +   +---+   +---+   +   +   +---+   +
|   |                               |   |   |   |               |           |           |   |           |               |       |       |       |       |       |       |       |           |   |   |   |       |   |
+   +---+---+   +---+---+---+---+---+   +   +   +   +---+   +---+---+---+---+---+---+   +   +   +---+   +---+---+   +---+---+---+   +---+---+---+   +---+---+   +   +---+   +   +---+---+---+   +   +---+---+   +   +
|   |       |                   |       |       |       |                   |       |   |       |       |       |   |                   |       |   |           |       |   |   |           |       |           |   |
+   +   +   +---+   +---+---+   +   +---+---+   +---+   +---+---+   +---+   +   +   +   +---+   +   +---+   +   +   +   +---+---+---+   +   +   +   +   +---+---+---+   +   +   +   +---+   +   +---+   +---+---+   +
|       |       |   |       |   |           |       |       |   |       |       |   |       |   |           |   |   |       |       |   |   |       |                   |   |   |   |   |       |               |   |
+---+---+---+   +   +   +   +   +---+---+   +---+---+---+   +   +---+   +---+---+   +---+   +---+---+---+---+   +   +---+   +   +---+   +   +---+---+   +---+---+   +---+   +---+   +   +---+---+---+---+---+   +   +
|       |   |   |   |   |       |       |   |           |           |       |           |               |       |   |       |   |       |           |   |       |   |       |       |   |                       |   |
+   +   +   +   +---+   +---+   +   +   +   +   +---+   +---+   +---+---+   +---+---+   +---+---+---+   +   +---+   +   +---+   +   +---+---+---+   +   +   +   +   +   +---+   +---+   +   +---+   +---+---+---+   +
|   |       |           |       |   |   |       |   |           |           |       |           |       |   |   |   |           |           |       |   |   |   |       |       |       |   |       |   |           |
+   +---+   +---+---+---+   +---+---+   +---+---+   +---+---+---+   +---+---+   +   +---+---+   +   +---+   +   +   +---+---+   +---+---+   +   +---+---+   +   +---+---+   +---+   +   +   +   +---+   +   +---+---+
|       |   |           |   |                       |               |           |   |       |   |   |       |   |       |           |       |               |           |       |   |       |   |       |   |       |
+   +   +   +   +---+   +   +   +   +---+---+---+---+   +---+---+   +   +---+---+   +   +   +   +   +   +   +   +---+   +   +---+---+   +   +---+---+---+---+---+---+   +---+   +---+---+---+   +   +---+   +   +---+
|   |   |   |   |   |       |   |       |               |   |       |           |   |   |       |   |   |   |           |   |           |           |       |       |       |           |       |       |   |       |
+---+   +   +   +   +---+---+---+---+   +   +---+---+---+   +   +---+---+---+   +   +---+   +---+   +   +   +   +---+---+   +   +---+---+---+---+   +   +   +---+   +---+   +---+---+   +   +---+---+   +   +---+   +
|       |   |   |       |           |   |   |                   |           |   |       |   |       |   |   |       |       |   |               |       |       |       |           |   |           |       |       |
+   +---+---+   +   +   +   +---+   +   +   +---+---+---+---+---+   +---+   +   +---+   +---+   +---+   +   +---+   +   +---+   +---+---+   +---+---+---+---+   +---+   +   +---+---+   +---+---+   +   +---+   +---+
|           |       |       |   |   |   |   |           |           |       |       |   |       |       |   |   |   |       |           |                   |   |       |   |           |           |   |           |
+   +---+   +---+---+---+---+   +   +   +   +   +---+   +   +---+---+   +---+---+   +   +   +---+---+---+   +   +   +---+---+---+---+   +   +---+---+---+   +   +   +   +   +   +---+---+   +---+---+   +---+---+   +
|       |                               |           |               |               |                       |                           |               |           |   |                   |                     E |
+---+---+---+---+---+---+---+---+---+---+---+---+---+---+---+---+---+---+---+---+---+---+---+---+---+---+---+---+---+---+---+---+---+---+---+---+---+---+---+---+---+---+---+---+---+---+---+---+---+---+---+---+---+

+---+---+---+---+---+---+---+---+---+---+---+---+---+---+---+---+---+---+---+---+---+---+---+---+---+---+---+---+---+---+---+---+---+---+---+---+---+---+---+---+---+---+---+---+---+---+---+---+---+---+---+---+---+
| @ | @   @   @ | @   @   @ | @   @   @   @   @   @             |           | @   @   @   @     | @   @   @     | @   @             |   | @   @   @   @   @     |           |           |           |               |
+   +   +---+   +   +---+   +   +---+---+---+   +   +---+---+   +---+   +   +   +---+---+   +---+   +---+   +---+   +   +---+---+   +   +   +---+---+---+   +   +   +---+   +   +---+---+   +---+   +   +---+   +---+
| @ | @ |   | @ | @ |   | @   @     | @   @ |   | @   @   @ |       |   |   | @ | @   @   @ | @   @ |   | @   @ | @ | @ |               | @ |   | @   @ | @ |       |   |   |       |       |   |   |       |       |
+   +   +   +   +   +   +---+---+---+   +   +---+---+---+   +---+   +   +   +   +   +---+---+   +---+   +---+   +   +   +---+---+---+---+   +   +   +   +   +---+---+   +   +---+   +---+---+   +   +---+---+---+   +
| @   @     | @ | @   @   @   @ | @   @ | @   @   @   @   @ |   |   |   |   | @ | @ | @   @ | @ |           | @ | @ | @ | @   @ | @   @   @ |   | @ | @   @ |           |               |           |       |       |
+   +---+---+   +---+---+---+   +   +---+---+---+---+---+---+   +   +   +   +   +   +   +   +   +   +---+---+   +   +   +   +   +   +---+---+   +   +---+---+   +   +---+---+---+---+   +   +---+---+   +   +   +---+
|   | @   @ | @ | @   @     | @ | @ |       |           |       |   |   |   | @ | @   @ | @   @ |           | @   @ | @   @ | @   @             | @ |       |   |               |       |   |           |   |       |
+---+   +   +   +   +   +---+   +   +   +   +   +   +---+   +   +   +   +---+   +---+---+---+---+   +---+   +---+---+---+---+---+---+---+---+---+   +   +   +   +---+---+---+   +   +---+   +   +---+---+   +---+   +
| @   @ | @   @ | @ | @   @   @ | @ |   |       |   |       |       |       | @ | @   @ |       |   |   |           |       | @   @   @   @ | @   @ |   |   |               |       |   |       |   |       |       |
+   +---+---+   +   +---+---+---+   +   +---+---+---+   +---+---+---+---+   +   +   +   +   +   +   +   +---+   +   +---+   +   +---+---+   +   +---+   +---+---+---+---+   +---+---+   +---+---+   +   +---+   +   +
| @ | @   @ |   | @ |       | @   @ |   |           |       |               | @   @ | @ |   |               |   |           | @   @ |   | @ | @   @ |   |       |       |   |                   |   |           |   |
+   +   +   +---+   +---+   +   +---+   +   +---+   +---+   +   +---+   +---+---+---+   +---+---+---+---+   +   +---+---+---+---+   +   +   +---+   +   +   +   +   +   +   +   +---+   +---+   +   +---+---+---+   +
| @   @ | @   @ | @   @   @ | @ |       |       |       |       |       | @   @   @   @ | @   @   @ |       |                   | @ |   | @ | @   @ |       |       |       |       |       |               |       |
+   +---+---+   +---+---+   +   +   +---+---+   +---+   +---+---+   +---+   +---+---+---+   +---+   +   +---+---+---+---+   +---+   +   +   +   +---+---+   +---+---+---+   +---+   +---+   +   +---+---+---+   +---+
|           | @         | @ | @ |           |       |   |               | @   @   @   @ | @ |     @ |   |           |       | @   @ |   | @   @ | @   @ |   | @   @   @ |       |   |       |   |               |   |
+   +---+---+   +---+---+   +   +   +---+   +---+   +   +   +---+---+---+---+---+---+   +   +---+   +   +---+---+   +   +   +   +---+   +---+   +   +   +---+   +---+   +---+   +---+   +---+   +   +---+---+---+   +
|   | @   @   @ | @   @   @ | @ |       |       |   |               | @   @   @   @ | @ | @   @ | @ |               |   |   | @ |               | @ | @ | @   @ |   | @   @ |       |   |       |   |               |
+   +   +---+---+   +---+---+   +---+   +---+   +   +---+---+---+---+   +---+---+   +   +---+   +   +---+---+---+   +   +   +   +   +---+---+---+   +   +   +---+   +---+   +---+   +   +   +---+   +---+   +---+---+
|   | @   @   @   @ | @   @   @ |   |   |   |   |       | @   @   @   @ | @   @   @ | @   @ | @ | @ | @   @ |   |   |   |   | @ |   | @   @ | @   @ | @   @ | @   @   @ | @ |           |       |       |           |
+---+---+---+---+---+   +---+---+   +   +   +   +---+   +   +---+---+---+   +---+   +---+   +   +   +   +   +   +   +   +   +   +---+   +   +   +---+---+---+   +---+   +   +---+---+---+---+---+---+   +   +---+   +
| @   @   @   @   @   @ |           |   |   |   |       | @   @ |       | @ |           | @ | @ | @   @ | @ |       |   |   | @ | @   @ | @ | @ | @   @   @   @ | @   @ | @   @   @ |                   |   |       |
+   +---+   +---+---+---+---+---+   +   +   +   +   +---+---+   +---+   +   +---+---+---+   +   +---+---+   +   +---+   +   +   +   +---+   +   +   +---+---+---+   +---+---+---+   +   +---+---+---+---+   +   +---+
| @ |       | @   @ | @   @   @ |           |       |       | @   @ |   | @   @   @   @   @ | @ |       | @ |       |   |   | @   @     | @ | @   @ |       | @   @     | @   @   @ |   |       |           |       |
+   +---+---+   +   +   +---+   +---+---+---+   +---+   +---+---+   +   +---+---+---+---+---+   +   +   +   +---+   +   +   +---+---+---+   +---+---+   +---+   +---+---+   +   +---+   +   +---+   +---+---+   +   +
| @   @   @ | @ | @   @ | @   @ | @   @   @ |   |               | @ |     @   @   @   @ |     @ |   |   | @ |   |   |   |       | @   @   @         | @   @   @ | @   @   @ |   |       |           |       |   |   |
+   +---+   +   +---+---+   +---+   +---+   +   +---+---+   +---+   +---+   +---+---+   +   +   +---+   +   +   +   +   +---+   +   +---+---+   +---+   +---+---+   +---+---+   +   +---+---+---+---+   +   +---+   +
|   |   | @   @ | @   @   @ | @   @ |   | @ |           |       | @   @   @ | @   @ | @ |   | @   @ | @   @ |       |   |   |   | @   @   @ |   | @   @ |       | @   @ |       |                   |   |       |   |
+   +   +---+---+   +---+   +   +---+   +   +---+---+   +---+   +---+---+---+   +   +   +---+---+   +   +---+   +---+   +   +   +---+---+   +   +   +---+   +   +---+   +---+---+---+---+---+---+   +   +---+   +   +
|           | @   @ |       | @ |       | @   @ |   |                       | @ | @ | @   @   @   @ | @ |   |   |       |   |   |       | @ |   | @ |       |       | @   @   @   @     |           |   |           |
+   +---+---+   +---+   +---+   +   +---+---+   +   +   +---+---+---+---+---+   +   +---+---+---+---+   +   +   +   +---+   +   +---+   +   +---+   +---+   +---+---+---+---+---+   +   +   +---+---+   +---+---+---+
|   | @   @   @ |           | @   @ | @   @   @ |       | @   @   @   @ | @   @ | @   @ | @   @ | @   @ |       |       |   |       |   | @   @ | @   @   @ | @   @   @   @ | @   @ |   |   |       |               |
+---+   +---+---+   +---+---+---+   +   +---+---+   +---+   +---+---+   +   +---+---+   +   +   +   +---+---+---+---+   +   +---+   +   +---+   +---+---+   +   +---+---+   +   +---+---+   +   +   +   +---+---+   +
| @   @ | @   @ |   | @   @   @   @ | @ |       |   |   | @ | @   @ | @   @ |       | @ | @ | @ | @ |           |       |       |   |       | @   @   @   @ | @ |   | @   @ | @ |           |   |           | @   @ |
+   +---+   +   +---+   +---+---+---+   +   +---+   +   +   +   +   +---+---+---+   +   +   +   +   +   +---+   +   +---+   +---+   +   +   +---+---+---+---+   +   +   +---+   +   +---+---+---+---+   +---+   +   +
| @   @   @ | @   @   @ |           | @ |               | @   @ | @ |     @   @ |   | @   @ | @   @ |   |   |       |       |       |   |   |       | @   @   @ |   | @ |     @ |   |               |   | @   @ | @ |
+   +---+---+---+---+---+---+---+   +   +   +---+---+---+---+---+   +---+   +   +   +---+---+---+---+   +   +---+---+   +   +   +---+   +   +   +---+   +---+---+   +   +---+   +   +---+   +---+   +   +   +---+   +
|   |                               | @ |   |   | @   @   @     | @   @   @ | @   @   @ |   |           |               |       |       |       | @   @ |       | @   @ | @   @ |           |   |   |   | @   @ | @ |
+   +---+---+   +---+---+---+---+---+   +   +   +   +---+   +---+---+---+---+---+---+   +   +   +---+   +---+---+   +---+---+---+   +---+---+---+   +---+---+   +   +---+   +   +---+---+---+   +   +---+---+   +   +
|   |       |                   | @   @ |       | @   @ | @   @   @         |       | @ |       |       |       |   |                   | @   @ | @ |           | @   @ | @ |   |           |       | @   @   @ | @ |
+   +   +   +---+   +---+---+   +   +---+---+   +---+   +---+---+   +---+   +   +   +   +---+   +   +---+   +   +   +   +---+---+---+   +   +   +   +   +---+---+---+   +   +   +   +---+   +   +---+   +---+---+   +
|       |       |   |       |   | @   @   @ |       | @   @ |   | @   @ |       |   | @   @ |   |           |   |   |       |       |   | @ | @   @ |             @   @ | @ |   |   |   |       |     @   @   @ | @ |
+---+---+---+   +   +   +   +   +---+---+   +---+---+---+   +   +---+   +---+---+   +---+   +---+---+---+---+   +   +---+   +   +---+   +   +---+---+   +---+---+   +---+   +---+   +   +---+---+---+---+---+   +   +
|       |   |   |   |   |       |       | @ | @   @   @ | @   @     | @   @ |           | @   @   @   @ |       |   |       |   |       | @   @   @ |   | @   @ | @ | @   @ |       |   |         @   @   @   @ | @ |
+   +   +   +   +---+   +---+   +   +   +   +   +---+   +---+   +---+---+   +---+---+   +---+---+---+   +   +---+   +   +---+   +   +---+---+---+   +   +   +   +   +   +---+   +---+   +   +---+   +---+---+---+   +
|   |       |           |       |   |   | @   @ |   | @   @   @ | @   @   @ | @   @ |           | @   @ |   |   |   |           |           | @   @ |   | @ | @ | @   @ |       |       |   | @   @ |   | @   @   @ |
+   +---+   +---+---+---+   +---+---+   +---+---+   +---+---+---+   +---+---+   +   +---+---+   +   +---+   +   +   +---+---+   +---+---+   +   +---+---+   +   +---+---+   +---+   +   +   +   +---+   +   +---+---+
|       |   |           |   |                       | @   @   @   @ | @   @   @ | @ |       |   | @ |       |   |       |           |       | @   @   @   @ | @   @   @ |       |   |       | @ |       | @ |       |
+   +   +   +   +---+   +   +   +   +---+---+---+---+   +---+---+   +   +---+---+   +   +   +   +   +   +   +   +---+   +   +---+---+   +   +---+---+---+---+---+---+   +---+   +---+---+---+   +   +---+   +   +---+
|   |   |   |   |   |       |   |       | @   @   @   @ |   |       | @   @   @ | @ |   |       | @ |   |   |           |   |           |           |       |       | @   @ |           | @   @ |       | @ |       |
+---+   +   +   +   +---+---+---+---+   +   +---+---+---+   +   +---+---+---+   +   +---+   +---+   +   +   +   +---+---+   +   +---+---+---+---+   +   +   +---+   +---+   +---+---+   +   +---+---+   +   +---+   +
|       |   |   |       |           |   | @ |                   | @   @   @ | @ | @   @ |   | @   @ |   |   |       |       |   |               |       |       |       | @         |   | @   @   @ | @   @ |       |
+   +---+---+   +   +   +   +---+   +   +   +---+---+---+---+---+   +---+   +   +---+   +---+   +---+   +   +---+   +   +---+   +---+---+   +---+---+---+---+   +---+   +   +---+---+   +---+---+   +   +---+   +---+
|           |       |       |   |   |   | @ | @   @   @ | @   @   @ | @   @ | @   @ | @ | @   @ |       |   |   |   |       |           |                   |   |       | @ |           | @   @   @ | @ |           |
+   +---+   +---+---+---+---+   +   +   +   +   +---+   +   +---+---+   +---+---+   +   +   +---+---+---+   +   +   +---+---+---+---+   +   +---+---+---+   +   +   +   +   +   +---+---+   +---+---+   +---+---+   +
|       |                               | @   @     | @   @         | @   @   @   @ | @   @                 |                           |               |           |   | @   @   @   @   @ |         @   @   @   @ |
+---+---+---+---+---+---+---+---+---+---+---+---+---+---+---+---+---+---+---+---+---+---+---+---+---+---+---+---+---+---+---+---+---+---+---+---+---+---+---+---+---+---+---+---+---+---+---+---+---+---+---+---+---+
