+---+---+---+---+---+---+---+---+---+---+---+---+---+---+---+---+---+---+---+---+
| S         |                       |       |                   |   |           |
+   +   +   +---+---+---+   +---+   +   +   +   +---+---+   +   +   +   +   +---+
|   |   |                   |   |       |   |       |       |   |       |       |
+   +   +---+---+---+---+---+   +---+---+   +   +---+   +---+   +---+---+---+   +
|   |   |       |                   |       |   |       |       |       |       |
+   +   +   +---+   +---+---+   +---+   +---+---+   +---+   +---+   +   +   +   +
|   |   |       |   |       |       |       |       |   |   |       |       |   |
+   +   +   +   +   +   +   +---+   +---+   +   +---+   +   +   +---+---+---+   +
|   |   |   |           |       |       |       |   |       |       |           |
+---+   +   +---+---+---+---+---+---+   +---+---+   +   +---+   +   +---+---+   +
|       |       |   |               |       |       |   |   |   |           |   |
+---+---+---+   +   +   +---+---+   +   +   +   +---+   +   +   +---+---+   +---+
|       |       |   |   |       |       |       |       |   |           |       |
+   +   +   +---+   +   +   +   +---+---+---+   +   +---+   +---+---+   +---+   +
|   |   |       |   |   |   |               |   |       |           |   |   |   |
+   +---+---+   +   +   +   +---+---+---+   +   +---+   +---+---+   +   +   +   +
|               |   |           |           |       |           |           |   |
+   +---+---+---+   +---+---+---+   +---+---+---+   +---+---+   +   +---+---+   +
|   |           |       |           |           |   |       |   |   |           |
+   +---+   +   +   +   +   +---+---+   +---+---+   +---+   +   +---+   +---+   +
|           |   |   |   |       |                           |           |       |
+---+---+---+   +   +   +---+   +---+   +---+---+---+---+---+---+---+---+   +---+
|           |       |   |   |       |       |                               |   |
+   +---+---+---+---+   +   +---+   +   +---+   +---+---+---+---+---+---+---+   +
|   |       |                   |   |   |       |       |                       |
+   +   +   +   +---+---+---+---+   +---+   +---+   +   +   +---+   +---+---+   +
|   |   |       |       |           |       |       |   |   |   |           |   |
+   +   +---+---+---+   +   +---+---+   +---+   +---+   +   +   +---+---+   +   +
|   |       |           |           |       |   |       |           |   |   |   |
+   +---+   +   +---+   +---+---+   +---+   +   +---+---+---+---+   +   +   +---+
|   |       |       |   |       |           |                           |       |
+   +   +---+---+   +   +---+   +---+---+---+   +---+---+---+---+---+---+---+   +
|   |       |       |       |   |               |           |               |   |
+   +---+   +   +---+---+   +   +   +---+---+   +---+---+   +   +---+---+   +   +
|       |   |   |           |       |       |               |       |   |   |   |
+   +   +   +   +   +---+---+---+---+   +   +---+   +---+---+---+   +   +   +   +
|   |   |       |   |           |       |   |       |           |   |   |       |
+   +---+---+---+   +---+   +   +   +---+   +---+---+   +---+   +   +   +---+   +
|                           |       |                   |           |         E |
+---+---+---+---+---+---+---+---+---+---+---+---+---+---+---+---+---+---+---+---+

+---+---+---+---+---+---+---+---+---+---+---+---+---+---+---+---+---+---+---+---+
| @   @   @ |             @   @   @ | @   @ |             @   @ |   |           |
+   +   +   +---+---+---+   +---+   +   +   +   +---+---+   +   +   +   +   +---+
|   |   | @   @   @   @   @ |   | @   @ | @ |       | @   @ | @ |       |       |
+   +   +---+---+---+---+---+   +---+---+   +   +---+   +---+   +---+---+---+   +
|   |   |       | @   @   @   @     | @   @ |   | @   @ | @   @ |       |       |
+   +   +   +---+   +---+---+   +---+   +---+---+   +---+   +---+   +   +   +   +
|   |   | @   @ | @ |       | @   @ | @   @ | @   @ |   | @ |       |       |   |
+   +   +   +   +   +   +   +---+   +---+   +   +---+   +   +   +---+---+---+   +
|   |   | @ | @   @     |       | @   @ | @   @ |   | @   @ |       |           |
+---+   +   +---+---+---+---+---+---+   +---+---+   +   +---+   +   +---+---+   +
|       | @   @ |   | @   @   @   @ | @     |       | @ |   |   |           |   |
+---+---+---+   +   +   +---+---+   +   +   +   +---+   +   +   +---+---+   +---+
|       | @   @ |   | @ | @   @ | @   @ |       | @   @ |   |           |       |
+   +   +   +---+   +   +   +   +---+---+---+   +   +---+   +---+---+   +---+   +
|   |   | @   @ |   | @ | @ | @   @   @   @ |   | @   @ |           |   |   |   |
+   +---+---+   +   +   +   +---+---+---+   +   +---+   +---+---+   +   +   +   +
| @   @   @   @ |   | @   @     | @   @   @ |       | @   @   @ |           |   |
+   +---+---+---+   +---+---+---+   +---+---+---+   +---+---+   +   +---+---+   +
| @ |     @   @ | @   @ | @   @   @ |           |   |       | @ |   | @   @   @ |
+   +---+   +   +   +   +   +---+---+   +---+---+   +---+   +   +---+   +---+   +
| @   @   @ | @ | @ | @ | @   @ |                           | @   @   @ | @   @ |
+---+---+---+   +   +   +---+   +---+   +---+---+---+---+---+---+---+---+   +---+
|           | @   @ | @ |   | @   @ |       | @   @   @   @   @   @   @   @ |   |
+   +---+---+---+---+   +   +---+   +   +---+   +---+---+---+---+---+---+---+   +
|   | @   @ | @   @   @         | @ |   | @   @ |       |                       |
+   +   +   +   +---+---+---+---+   +---+   +---+   +   +   +---+   +---+---+   +
|   | @ | @   @ |       | @   @   @ | @   @ |       |   |   |   |           |   |
+   +   +---+---+---+   +   +---+---+   +---+   +---+   +   +   +---+---+   +   +
|   | @   @ | @   @   @ | @   @   @ | @   @ |   |       |           |   |   |   |
+   +---+   +   +---+   +---+---+   +---+   +   +---+---+---+---+   +   +   +---+
|   | @   @ | @   @ | @ |       | @   @   @ |                           |       |
+   +   +---+---+   +   +---+   +---+---+---+   +---+---+---+---+---+---+---+   +
|   | @   @ | @   @ | @   @ |   |               |           | @   @   @   @ |   |
+   +---+   +   +---+---+   +   +   +---+---+   +---+---+   +   +---+---+   +   +
|       | @ | @ | @   @   @ |       | @   @ |               | @   @ |   | @ |   |
+   +   +   +   +   +---+---+---+---+   +   +---+   +---+---+---+   +   +   +   +
|   |   | @   @ | @ |     @   @ | @   @ | @ |       | @   @   @ | @ |   | @   @ |
+   +---+---+---+   +---+   +   +   +---+   +---+---+   +---+   +   +   +---+   +
|                 @   @   @ | @   @ |     @   @   @   @ |     @   @ |         @ |
+---+---+---+---+---+---+---+---+---+---+---+---+---+---+---+---+---+---+---+---+
